  C 21, 255, 20
NO ./textures/north_texture.png
SO ./textures/south_texture.png
                             
WE ./textures/west_texture.png
F 42              ,24,44 
EA ./textures/east_texture.png



111111111111111111
101111111111111001
1000E0000011111001
1000000000000000111
11111111111111111111